1111111111111111
1.....1111.....1
1.111.1..1.111.1
1.13........31.1
1.1.17111171.1.1
1..............1
1.14.11--11.41.1
1..1.1....1.1..1
1..1.1....1.1..1
1.14.111111.41.1
1..............1
1.1..11..11..1.1
1.11..1..1..11.1
1.311......113.1
1.....1111.....1
1111111111111111
